Z->gY|@
Y->b(X)SgY|3()S
X->gbW
W->,X|@
V->b9
9->,V|@
S->{AC4b;}|@
A->BA|@
B->gb;
C->DC|@
D->E|F|G|I|H|J|L|;
E->c(M)DQ
Q->dD
F->f(M)D
G->e(K;M;K)D
H->hN;
I->ib;
J->{C}
K->b=N
L->K;
M->jk
j->NR
k->6jk|5jk|@
N->OT
R->>N|<N|wN|xN|yN|zN
T->+OT|-OT|@
O->PU
U->*PU|/PU|@
P->a|b8|(N)
8->(V)|@
